1111111111111111111111111111111111111111111111111111111
10000000P0000000000000000000000000000000000000000000011
1000000000000000000000000000000000000000000000000000011
1000000000000000000000000000000000000000000000000000011
1000000000000000000000000000000000000000000000000000011
1000000000000000000000000000000000000000000000000000011
1000000000000000000000000000000000000000000000000000011
1000000000000000000000000000000000000000000000000000011
1000000000000000000000000000000000000000000000000000011
1000000000000000000000000000000000000000000000000000011
1000000000000000000000000000000000000000000000000000011
1000000000000000000000000000000000000000000000000000011
1000000000000000000000000000000000000000000000000000011
1000000000000000000000000000000000000000000000000000011
1000000000000000000000000000000000000000000000000000011
1000000000000000000000000000000000000000000000000000011
1000000000000000000000000000000000000000000000000000011
1000000000000000000000000000000000000000000000000000011
1000000000000000000000000000000000000000000000000000011
1000000000000000000000000000000000000000000000000000011
1000000000000000000000000000000000000000000000000000011
1000000000000000000000000000000000000000000000000000011
1000000000000000000000000000000000000000000000000000011
10000000C0000000000000000000000000000000000000000000011
1000000000000000000000000000000000000000000000000000011
1000000000000000000000000000000000000000000000000000011
1000000000000000E00000000000000000000000000000000000011
1000000000000000000000000000000000000000000000000000011
1000000000000000000000000000000000000000000000000000011
1000000000000000000000000000000000000000000000000000011
1111111111111111111111111111111111111111111111111111111
1111111111111111111111111111111111111111111111111111111
